⭐ *Kosakata* ⭐
_Nama Makanan Indonesia dalam Bahasa Inggris_

Nama-nama makanan, jenis pakaian, rumah adat, dll. yang asli Indonesia atau suatu wilayah tidak perlu diterjemahkan. Namun, kita bisa memberikan penjelasan mengenai benda tersebut agar orang asing bisa memahami benda tersebut.

Bahasa Inggris _"ketupat"_ tetaplah ketupat. Kita bisa jelaskan bahwa ketupat adalah _*"steamed diamond shaped rice"*_.

Nama-nama makanan Indonesia dalam Bahasa Inggris:

_"lontong"_ = _*"rice cake/ rice roll"*_

_rendang_ = _*"meat simmered in spices and coconut milk"*_

Lemper  = Sweet Stuffed Sticky Rice Roll

Tahu Telor  = Tofu Omelets

Nasi Goreng Babat =  Tripe Fried Rice

Nasi Kunyit  = Turmeric Rice

Gudeg Putih  = White Curry Jackfruit

Udang Garang Asam  = Prawns in Tamarind Sauce

Rempeyek Udang = Shrimp Fritters

Nasi Uduk  = Rice Cooked in Coconut Milk

Lontong = Rice Cake

Rujak Manis = Fruit in Soy Sauce

Sayur Lodeh = Vegetables Cooked in Coconut milk

Semur Daging = Beef in Soy Sauce

Serundeng = Baked Coconut Topping

Pepes Udang = Shrimp in Spicy Nut Sauce

Sambal Terasi = Shrimp Paste Sambal

Spiku = Indonesian Layer Cake

Rendang = Spicy Coconut Beef

Goreng Ati Sambal = Spicy Sweet Chicken Liver Saute

Siomay Bandung = Steamed Dumplings Bandung Style

Pepes Telor Ikan = Steamed Fish Roe

Otak-Otak Bandeng = Stuffed Milkfish

Tahu Isi = Stuffed Soybean Cake

Arem-Arem = Stuffed Rice Rolls

Semur Terong = Sweet Eggplant Stew

Tahu Telor = Indonesian Tofu with Peanut Butter

Gado-Gado = Mixed Vegetables with Peanut Sauce Dressing

Nasi Kuning = Yellow Rice

Nasi Gurih = Fragrant Rice/ Coconut Rice

Orak-Arik = Cabbage Scramble

Semur Lidah = Ox Tongue in Sweet Nutmeg Sauce

Keredok = Fresh Salad with Peanut Sauce

Babat Goreng = Fried Beef Tripe

Tempe Goreng = Fried Fermented Soybean Cakes

Gado-Gado = Mixed Vegetables with Peanut Sauce

Asinan = Sweet and Sour Cucumber Salad

Ayam Panggang Kecap = Barbecued Chicken in Sweet Soy Sauce

Semur Otak = Beef Brain Sautéed in Spiced Sauce

Sate Daging = Beef on a Stick with Peanut Sauce

Opor Ayam = Braised Chicken in Coconut Milk

Ayam Panggang Klaten = Chicken in Aromatic Nut Sauce

Laksa = Coconut Milk in Chicken Broth with Garnishes

Urap-Urap = Cooked Vegetables with Grated Coconut

Kue Semprong = Crispy Sweet Rolls

Sambal Ulek = Crushed Chiles

Martabak Telor = Deep Fried Beef and Vegetables Wrap

Rawon =Diced Beef in Black Sauce Soup

Sambal Terasi = Dried Shrimp Chili Sauce

Tahu Goreng = Fried Soybean Curd