⭐ *単語 Tango* • Kosakata ⭐
☆ Kata Sifat NA berakhiran I ☆

Seperti yang kita ketahui bahwa tidak semua kata sifat yang berakhiran い i dapat dikategorikan ke dalam kata sifat i. Beberapa masuk dalam kata sifat なna.

Sebenarnya untuk membedakannya, kita hanya perlu melihat kanjinya. Jika dituliskan dalam full kanji, tidak akan tertulis akhiran いi dengan hiragana jika dia adalah kata sifat NA. Tetapi beberapa ada juga yang tetap berakhiran いi hiragana.

Berikut adalah contoh-contohnya:

• 曖昧 aimai     - ambigu
• 安易 an'i - mudah, sederhana
• 安静 ansei     - tenang
• 安定 antei      - stabil
• 案外 angai - tak terduga, mengejutkan
• 一定 ittei        - tetap
• 一生懸命 isshoukenmei - sekuat tenaga, sebisa mungkin
• 意外 igai        - tak terduga
• 偉大 idai        - agung
• 一杯 ippai     - penuh
• 寛大 kandai - toleran, open-minded
• 嫌い kirai       - dibenci
• 綺麗 kirei       - indah, cantik
• 軽快 keikai   - ringan
• 賢明 kenmei - bijak
• 懸命 kenmai - bersemangat, bertekad
• 健在 kenzai  - sehat
• 光栄 kouei   - terhormat
• 公正 kousei   - adil
• 広範囲 kouhan'i = luas, mencakup banyak
• 公平 kouhei   - adil
• 広大 koudai  - luas
• 滑稽 kokkei  - lucu, lawak
• 巨大 kyodai   - raksasa
• 最低 saitei - terendah, terburuk
• 幸い saiwai - bahagia, beruntung
• 神聖 shinsei - suci
• 心配 shinpai  - khawatir
• 水平 suihei    - datar
• 盛大 seidai - berkekuatan besar
• 繊細 sensai - halus, lemah
• 壮大 soudai - mengagumkan
• 詳細 shousai - rinci
• 大抵 taitei     - biasanya
• 丁寧 teinei    - sopan
• 透明 toumei  - transparan
• 得意 tokui     - berhasil, sejahtera
• 多大 tadai   - sangat banyak
• 著名 chomei - diketahui dengan baik
• 反対 hantai    - berlawanan
• 不安定 fuantei - tidak stabil
• 不意 fui        - tiba-tiba
• 不快 fukai - tidak menyenangkan
• 不公平 fukouhei - tidak adil
• 不正 fusei     - tidak adil
• 不平 fuhei    - tidak puas
• 不明 fumei  - tidak jelas
• 不愉快 fuyukai - tidak menyenangkan
• 平静 heisei  - tenang
• 未定 mitei - tidak tetap, tidak pasti
• 無関係 mukankei - tidak berhubungan
• 厄介 yakkai - membebani, menjadi masalah
• 優勢 yuusei  - berkuasa
• 有名 yuumei  - terkenal
• 有害 yuugai  - berbahaya
• 雄大 yuudai - agung
• 愉快 yukai  - menyenangkan
• 容易 youi - sederhana, mudah
• 余計 yokei  - berlebihan
• 冷静 reisei  - tenang, sejuk
• 論外 rongai - tidak mungkin
• 自在 jizai     - sesuka hati
• 重大 juudai - serius, penting
• 純粋 junsui - murni
• 忠誠 chuusei - setia
• 莫大 bakudai - besar, kolosal
• 無礼 burei - kasar, tidak sopan
• 膨大 boudai - besar, luas, kolosal

_____________________________
27-4-21 | 🇯🇵 Belajar Nihon-go